+-----------------------+
|XX   XXX    VVVVVVVVVV |
|   XXO   XX VVVVVVVVVV | 
| X   X XX X            |
| XXX   XX XXXXXXXX    X|
|   XXXXX     X    X   X|
| X  X  X FFF X X  X X  |
| X X   X FFF X XX   X X|
| XO  X   FFF X   X X  X|
| XXX X X FFF XXX X XX X|
|         FFF   X X    X|
|XX  XX X FFF X X  XX   |
|X    X X FFF X OXX     |
|X PP X X     XX X  EE  |
+-----------------------+